#!!!!!#############################
#                                 #
#   #############   ###############
#   #############          ########
#   #       #########    ! ########
#   #   #   ##             ########
#   #   !        ##################
#   #   ###########################
# @ #                !!!###########
#   #   #####!!!##                >
###################################